111111111111111111111111111111111
1P0000000000000000000000000000001
111111111111111111111111111111101
1000000000000000C0000000000000001
101111111111111111111111111111111
1000000000000C0000000000000000001
111111111111111111111111111111101
1000000000000C0000000000000000001
101111111111111111111111111111111
100000000000000000000000000000001
111111111111111111111111111111101
1EC000000000000000000000000000001
111111111111111111111111111111111