111111111
000000000
111111111
ECP111111